12 7
WWWWWWWWWWWW
WG0E0W0AWWWW
WWWW0e0aWWWW
Wc00WWCW000W
W0W0SW00WW0W
Wd000D00000W
WWWWWWWWWWWW
