11 5
WWWWWWWWWWW
WWW0A00WWWW
WS00WW0WWWW
WaWWWW00GWW
WWWWWWWWWWW
