10 10
WWWWWWWWWW
WWWG0EaWWW
WbWWWWB0WW
W0000000WW
WWWWDWWWWW
WdC00000WW
WW000W00cW
WSW000WWWW
W000WAe00W
WWWWWWWWWW
