12 6
WWWWWWWWWWWW
WWW000000WWW
WWW000000WWW
WWW00WWWSWWW
WW000GWWWWWW
WWWWWWWWWWWW
