9 10
GEWWW0000
W0e000WWD
WWWWWW000
d0000W0WW
WWW00000W
000WWBWWW
0W00000bW
A0WWWWWWW
W00a000WW
WWWWWS00W
