27 15
WWWWWWWWWWWWWWWWWWWWWWWWWWW
WWWWWWWW0WWWWWEWWWWWWWWWWWW
WW000000B000000000000000WWW
W00WWWWWWWWWWWWWWWWWCWWWWWW
W000WWWWWWW000000000000WWWW
WWWAWW0a00000WWWWWWWWW0WWWW
WWG0WW00WWWW0WWWWWW0D00WWWW
WWWWWWW0WWWW0WWWWWW0WWWWWWW
WWSWWWWWWWW0000b0000WWWWWWW
WW0000W000W0WWWWWWW0WWWWWWW
WWWW0WW0W0W00WWWWWW0WWWWWWW
WWW00WWdWWWW0WWc0000WWWWWWW
We0000000000WWWWW0WWWWWWWWW
WWWW0WWWWWW0000000WWWWWWWWW
WWWWWWWWWWWWWWWWWWWWWWWWWWW
